1111111
2222222
3333333
44444444
5555555
6666666
777777
888888
