R 800    600
NO ./textures/cropped_1.xpm
WE ./textures/cropped_109.xpm
EA ./textures/cropped_15.xpm
S ./textures/pillar.xpm



C 150,150,150

F 90,90,1


        1111111111111111111111111
        1000000000110000110000001
        1011000001110001  100001
        1001000000000000110000001
111111111011000001110000000000001
100000000011000001110111112111111
11110111111111011100000012021
11110111111111011101010012021
11000000110101011100000012021
10001000000000001100000010201
1E000000000000001101010010001
1100000111010101111101111000111
11110111 1110101 101111010001
11111111 1111111 111111111111
SO ./textures/cropped_11.xpm
