R 800 600
NO ./textures/cropped_1.xpm
SO ./textures/cropped_11.xpm
WE ./textures/cropped_109.xpm
EA ./textures/cropped_15.xpm
S ./textures/pillar.xpm
C 150,150,150
F 90,90,90



111111111111
122222222221
122222222221111111
12222222222E0000001
122222222221111111
122222222221
111111111111
